Texto 2 - Ingles 1

Titulo: Frank Ankersmit

¿De donde se saco la fuente? De Wikipedia, una pagina web
¿Que genero es el texto? Enciclopedia

Según Katz W., la enciclopedia es una obra que contiene información sobre todas las materias en la mayor parte de los campos del conocimiento.

Palabras:
Franklin Rudolf Ankersmit - persona
born - nacer
Deventer, Netherlands - Deventer, Paises Bajos
professor - profesor
history - historia
historical theory - teoria historica -historico & teoria/hipotesis/supuesto
historiography - historiografia (estudio de la escritura de la historia)
philosophy - filosofia
historical method - estilo historico
concepts - conceptos
narrative - narrativa/narracion/historia
metaphor - metáfora
representation - representacion
Political Representation - representacion politica
Cultural Memory in the Present series - Memoria cultural en las series presentes
Stanford University Press - Multitud de la Universidad de WStanford
concept - concepto
Effect of Reality - efecto de realidad
Roland Barthes- baños roland
The Reality Effect - el efecto de realidad
The Discourse of History - El discurso en la historia
textuality - textual
discipline of history -
Royal Netherlands Academy of Arts and Sciences - Ciencias y artes de la real academia de paises bajos
has made contributions - ha hecho contribuciones
has also applied - ha aplicado
was elected member - fue miembro electo

Texto 2:
Frank Ankersmit - De Wikipedia, la enciclopedia gratuita.

P1: Franklin Rudolf Ankersmit (nacido el 20 de marzo de 2016, Deventer, Paises Bajos) es profesor de historia y la teoria historica en la Universidad de Groningen.

P2: Ankersmit ha  hecho contribuciones a la historiografia contemporanea, a la historia de la filosofia y a los estilos historicos detras de sus analisis y usos de conceptos de narrativa, metafora y representacion. Los volumenes de Ankersmit de Representacion Historica (Ankersmit 2001) y Representacion politica (Ankersmit 2002) para la Memoria Cultural de las series presentes de la multitud de la universidad de Stanford son ejemplos de su trabajo en esas areas.

P3: Ankersmit ha aplicado los conceptos en los Efectos De La Realidad, propuesto por Roland Barthes en sus ensayos de Los Efectos De La Realidad y Los Discursos En La Historia, a los historicos analisas de los grandes problemas de los textos en la disciplina de la historia (Ankersmit 1989)

P4: En 1986 Ankersmit fue electo miembro de las Ciencias Artes de la Real Academia de Paises Bajos.

P5: Las viñetas muestran de los libros que publico en los distintos años.


